9 200 0

23 -2 41 23 -2 45 23 -2 46 23 -1 108 0 0 -1 118 0 0 -1 107 0 0 23 -2 65 23 -2 66 
23 23 -2 115 31 -2 86 23 -2 61 -1 129 0 0 23 -1 137 0 0 -1 138 0 1 -2 105 138 -2 106 
-1 118 0 0 -1 118 0 0 -1 107 0 0 23 -1 129 0 0 23 23 -2 51 -1 23 0 0 -2 85 -1 23 0 0 -2 116 
-1 23 1 1 -2 66 -1 23 0 0 -2 41 -1 137 0 0 -1 138 0 0 -1 139 0 0 23 23 23 -2 61 23 -2 71 
-1 23 1 1 -2 76 23 -1 23 1 1 -2 95 -1 23 1 1 -2 96 23 23 23 -2 73 -1 23 1 1 -2 95 -1 23 1 1 -2 96 
-1 23 0 0 -2 86 23 -2 73 -1 23 1 1 -2 105 -1 23 1 1 -2 106 23 -1 23 1 1 -2 65 -1 30 1 1 -2 66 -1 23 1 1 -2 105 -1 23 1 1 -2 106 
-1 30 1 1 -2 35 -1 23 1 1 -2 36 -1 23 0 0 -2 85 -1 23 0 0 -2 86 23 -2 72 -1 23 1 1 -2 75 -1 23 1 1 -2 46 -1 31 0 0 -2 85 -1 23 0 0 -2 86 
-1 23 1 1 -2 45 -1 23 1 1 -2 76 -1 23 1 1 -2 65 -1 23 1 1 -2 66 31 -1 23 0 0 -2 115 -1 23 0 0 -2 116 -1 23 1 1 -2 65 -1 23 1 1 -2 96 
-1 23 0 0 -2 85 -1 23 0 0 -2 56 -1 23 1 1 -2 75 -1 23 1 1 -2 76 23 -2 72 23 -1 23 0 0 -2 41 -1 23 1 1 -2 105 -1 31 1 1 -2 76 
23 -2 72 23 -2 60 -1 23 0 0 -2 115 -1 30 0 0 -2 56 23 -2 71 30 23 -2 70 -1 23 0 0 -2 115 -1 23 0 0 -2 116 
-1 23 0 0 -2 40 -1 23 1 1 -2 95 -1 23 1 1 -2 96 0 25 -2 47 23 25 -2 49 25 25 
23 -1 23 1 1 -2 75 -1 23 1 1 -2 106 16 12 23 5 -2 59 5 5 
23 -2 70 -1 23 0 0 -2 115 -1 23 0 0 -2 116 16 -1 12 0 0 -2 41 23 -2 72 23 11 23 -2 74 
0 25 25 26 12 31 0 25 2 
26 13 3 4 21 -2 57 23 -2 50 21 -2 17 21 22 
5 5 5 22 23 23 -2 73 23 23 -2 51 23 
23 -2 61 23 -2 51 23 -1 23 0 0 -2 40 23 -2 82 -1 23 0 0 -2 40 23 23 23 -2 70 
-1 23 0 0 -2 42 -1 23 0 0 -2 43 -1 23 0 0 -2 43 -1 23 0 0 -2 44 23 -2 92 -1 23 0 0 -2 42 -1 23 0 0 -2 43 -1 23 0 0 -2 43 -1 23 0 0 -2 44 
23 23 -2 72 23 23 23 -2 92 23 23 -2 62 23 -2 51 23 -2 50 
23 -2 60 23 23 -2 51 23 -2 91 23 -2 92 23 23 -2 71 23 23 
23 -3 2 23 -2 70 23 -3 2 -2 62 23 23 -3 2 -2 92 23 -2 93 23 -3 2 23 23 -3 2 -2 74 
-1 23 0 0 -2 42 -1 23 0 0 -2 43 -1 23 0 0 -2 43 -1 23 0 0 -2 44 23 -2 92 -1 23 0 0 -2 42 -1 23 0 0 -2 43 -1 23 0 0 -2 43 -1 23 0 0 -2 44 
23 -2 74 23 23 -2 82 23 23 -2 92 23 -2 93 23 -2 82 23 23 -2 51 
23 -2 91 23 -2 92 23 -2 92 23 -2 92 23 -2 92 23 -2 92 23 -2 92 23 -2 92 23 -2 93 
23 23 -2 92 23 -3 2 -2 93 23 -2 51 23 -3 2 23 23 -3 2 -2 102 23 -2 92 23 -2 50 
-1 23 0 0 -2 44 23 -2 92 -1 23 0 0 -2 42 -1 23 0 0 -2 43 -1 23 0 0 -2 43 -1 23 0 0 -2 43 -1 23 0 0 -2 44 23 -2 92 -1 23 0 0 -2 42 
23 23 -2 92 23 -2 93 23 -2 50 23 -2 82 23 23 -2 82 23 -2 92 23 
23 23 -2 92 23 -2 92 23 -2 92 23 -2 92 23 -2 92 23 -2 92 23 -2 92 23 -2 74 
23 23 -2 102 23 23 -2 52 23 -2 92 23 -2 102 23 23 -2 102 23 
23 -2 52 23 23 -1 23 0 0 -2 40 23 -2 92 -1 23 0 0 -2 40 23 23 -2 72 23 
3 -2 25 1 -3 2 -2 51 3 -2 9 23 0 -2 102 2 23 23 -2 70 23 
3 3 24 25 26 14 11 23 0 
3 13 13 -3 2 3 13 24 25 25 26 
5 6 -1 15 0 0 -2 41 13 3 3 -3 2 3 3 3 
23 -2 72 20 21 6 -1 32 0 0 -2 63 -1 33 0 0 -2 53 -1 33 0 0 -2 63 -1 33 0 0 -2 53 -1 34 0 0 -2 53 
31 23 23 -2 61 10 -1 32 0 0 -2 63 -1 33 0 0 -2 63 -1 33 0 0 -2 53 -1 33 0 0 -2 63 -1 34 0 0 -2 53 
23 -2 50 23 23 10 -1 32 0 0 -2 53 -1 33 0 0 -2 63 -1 33 0 0 -2 63 -1 33 0 0 -2 53 -1 34 0 0 -2 63 
12 -2 8 23 -2 59 23 -2 60 0 -2 10 13 -3 1 13 13 -3 1 3 3 -3 1 
23 -2 22 23 -3 1 31 10 -1 32 0 0 -2 64 -1 33 0 0 -2 54 -1 33 0 0 -2 54 -1 33 0 0 -2 64 -1 34 0 0 -2 54 
23 -2 61 23 -2 60 23 10 -1 32 0 0 -2 54 -1 33 0 0 -2 64 -1 33 0 0 -2 64 -1 33 0 0 -2 64 -1 34 0 0 -2 64 
23 23 23 -2 50 10 -1 32 0 0 -2 64 -1 33 0 0 -2 64 -1 33 0 0 -2 54 -1 33 0 0 -2 54 -1 34 0 0 -2 64 
-1 23 0 0 -2 40 23 -2 74 23 20 -3 1 -2 51 5 5 5 3 -2 6 3 
25 25 25 25 25 2 23 -2 51 3 -2 20 3 -2 6 
-1 32 0 0 -2 53 -1 33 0 0 -2 63 -1 33 0 0 -2 63 -1 33 0 0 -2 53 -1 34 0 0 -2 63 12 23 23 -2 61 10 
-1 32 0 0 -2 63 -1 33 0 0 -2 53 -1 33 0 0 -2 63 -1 33 0 0 -2 53 -1 34 0 0 -2 63 12 23 -2 62 23 20 
-1 32 0 0 -2 63 -1 33 0 0 -2 63 -1 33 0 0 -2 53 -1 33 0 0 -2 63 -1 34 0 0 -2 53 24 2 31 23 -2 50 
3 -3 1 3 3 -3 1 34 -2 13 3 -3 1 3 14 -2 50 23 0 
-1 32 0 0 -2 64 -1 33 0 0 -2 64 -1 33 0 0 -2 64 -1 33 0 0 -2 64 -1 34 0 0 -2 64 4 22 23 16 
-1 32 0 0 -2 64 -1 33 0 0 -2 64 -1 33 0 0 -2 64 -1 33 0 0 -2 64 -1 34 0 0 -2 64 24 2 -2 62 11 16 
-1 32 0 0 -2 64 -1 33 0 0 -2 64 -1 33 0 0 -2 64 -1 33 0 0 -2 64 -1 34 0 0 -2 64 3 24 25 -2 19 26 -2 17 
3 13 3 34 -2 13 13 3 13 3 -2 19 3 -2 17 
-1 21 0 0 -2 68 -1 21 0 0 -2 69 21 -2 82 21 -1 21 0 0 -2 68 -1 21 0 0 -2 88 -1 21 0 0 -2 68 -1 22 0 0 -2 68 -1 20 0 0 -2 69 
13 -2 1 -1 2 0 0 -2 79 23 -2 92 23 -2 82 0 1 1 1 -1 2 0 0 -2 79 
13 -1 12 0 0 -2 79 23 -2 92 23 -2 92 10 -1 32 0 0 -1 33 0 0 -1 34 0 0 -1 12 0 0 -2 79 
13 -1 12 0 0 -2 79 23 -2 92 23 -2 92 -1 10 0 0 -2 99 -1 32 0 0 -1 33 0 0 -1 34 0 0 -1 12 0 0 -2 79 
13 -1 12 0 0 -2 79 23 -2 102 23 -2 92 -1 10 0 0 -2 77 -1 32 0 0 -1 33 0 0 -1 34 0 0 -1 12 0 0 -2 79 
-1 22 0 0 -2 88 -1 22 0 0 -2 89 23 -2 91 23 -2 92 -1 20 0 0 -2 87 -1 5 0 0 -2 88 -1 5 0 0 -2 68 -1 5 0 0 -2 88 -1 22 0 0 -2 89 
23 -2 62 23 -3 2 23 -2 91 23 -2 92 23 -3 2 -2 92 23 -2 93 23 23 -3 2 23 
-1 23 0 0 -2 68 23 -2 50 -1 23 0 0 -2 68 -1 23 0 0 -2 69 23 -2 92 -1 23 0 0 -2 67 -1 23 0 0 -2 68 -1 23 0 0 -2 88 -1 23 0 0 -2 69 
11 -3 1 -2 63 11 -2 64 11 -3 1 -2 63 -1 23 0 0 -2 79 23 -2 92 -1 23 0 0 -2 77 0 -3 2 2 -2 72 -1 23 0 0 -2 79 
11 -2 64 11 -3 1 -2 63 11 -2 64 -1 23 0 0 -2 79 23 -2 92 -1 23 0 0 -2 77 20 -2 74 22 -3 2 -2 62 -1 23 0 0 -2 79 
-1 23 0 0 -2 88 -1 23 0 0 -2 68 -1 23 0 0 -2 88 -1 23 0 0 -2 89 23 -2 92 -1 23 0 0 -2 87 23 -2 51 -1 23 0 0 -2 88 -1 23 0 0 -2 89 
-1 107 0 0 23 -2 50 23 23 -2 91 23 -2 92 23 -2 93 23 23 23 
-1 127 0 0 23 -4 1 23 -2 70 -1 108 0 0 118 -2 128 -1 118 0 0 118 -2 128 -1 107 0 0 23 
-1 137 0 0 -1 138 0 0 -1 138 0 0 -1 139 0 0 23 23 -2 72 23 -1 137 0 0 -1 138 0 0 
23 23 -2 60 23 23 23 23 23 0 2 
-1 119 0 0 23 23 23 -2 70 23 23 23 20 24 -2 39 
-1 139 0 0 23 0 -3 1 1 1 2 -3 2 23 -2 60 0 26 
23 -2 62 0 26 4 6 24 -2 37 0 26 3 
23 10 3 -2 4 14 -2 38 16 -3 1 -2 51 13 -2 24 3 -2 26 3 3 
23 10 4 -2 57 22 -2 58 20 21 21 21 -1 21 0 0 -2 40 
23 -2 70 20 -1 22 0 0 -2 41 23 23 23 -3 1 -2 61 30 23 23 
23 -2 52 23 23 23 23 -2 50 23 23 23 23 -2 61 
23 23 -2 61 23 -2 51 -1 23 0 0 -2 42 -1 23 0 0 -2 43 -1 23 0 0 -2 43 -1 23 0 0 -2 43 -1 23 0 0 -2 43 -1 23 0 0 -2 44 
31 23 -3 2 23 23 30 23 23 -2 60 23 23 
23 23 23 -2 70 23 23 23 23 23 -3 2 -1 23 0 0 -2 40 
-1 23 0 0 -2 42 -1 23 0 0 -2 43 -1 23 0 0 -2 43 -1 23 0 0 -2 43 -1 23 0 0 -2 43 -1 23 0 0 -2 44 31 23 -2 51 23  
0 -2 50 25 2 23 -2 82 23 23 23 23 23 -3 2 -2 62 
26 13 12 23 -2 102 23 30 -1 23 0 0 -2 41 23 23 -2 73 
-1 15 0 0 -2 41 13 24 -2 47 -1 23 0 0 -2 42 -1 23 0 0 -2 43 -1 23 0 0 -2 43 -1 23 0 0 -2 43 -1 23 0 0 -2 43 -1 23 0 0 -2 44 
13 13 24 -2 37 0 24 -2 59 2 0 -2 39 26 -3 3 -2 57 25 
3 13 24 26 3 24 26 3 3 
3 3 13 3 23 -2 3 3 3 3 13 
3 3 3 -1 32 0 0 -1 33 0 0 -1 34 0 0 13 3 3 
-1 33 0 0 -2 53 -1 34 0 0 -2 53 13 13 13 13 13 -1 32 0 0 -2 63 -1 33 0 0 -2 53 
-1 3 1 1 -2 65 -1 3 1 1 -2 66 13 -3 3 -1 32 0 0 -2 51 -1 33 0 0 -2 50 -1 34 0 0 -2 61 13 -3 3 3 3 
-1 33 0 1 -2 75 -1 34 0 1 -2 76 3 13 13 13 3 -1 32 0 0 -2 63 -1 33 0 0 -2 63 
-1 5 0 0 -2 85 -1 6 0 0 -2 86 3 -1 32 0 0 -2 51 -1 33 0 0 -2 64 -1 34 0 0 -2 50 3 3 3 
23 20 6 3 3 3 3 3 3 
23 -2 51 23 -1 20 1 1 -2 65 -1 21 1 1 -2 66 21 -2 70 21 -1 6 1 1 -2 35 -1 3 1 1 -2 36 4 
-1 23 1 1 -2 95 -1 23 1 1 -2 96 -1 23 1 1 -2 105 -1 23 1 1 -2 106 23 -2 60 23 -1 20 1 1 -2 75 -1 5 1 1 -2 46 22 
-1 23 1 1 -2 75 -1 23 1 1 -2 76 -1 23 0 0 -2 55 -1 23 0 0 -2 56 23 23 -1 23 0 0 -2 55 -1 23 0 0 -2 56 23 
-1 23 0 0 -2 55 -1 23 0 0 -2 56 23 -2 60 23 23 23 -2 73 23 23 23 
23 -2 72 23 -1 23 0 0 -2 68 -1 23 0 0 -2 69 23 23 23 -2 60 23 23 -2 71 
-1 23 0 0 -2 43 -1 23 0 0 -2 44 23 -1 23 0 0 -2 87 -1 23 0 0 -2 68 -1 23 0 0 -2 88 -1 23 0 0 -2 68 23 -1 23 0 0 -2 68 
23 23 -2 61 23 -3 4 23 23 -2 72 -1 23 0 0 -2 109 23 23 -2 61 23  
23 -1 23 0 0 -2 99 23 -1 23 0 0 -2 67 -1 23 0 0 -2 68 -1 23 0 0 -2 89 23 31 23 
23 -2 60 -1 23 0 0 -2 87 23 -1 23 0 0 -2 87 23 -2 61 23 23 23 -2 92 23 
23 -1 23 0 0 -2 99 23 -2 72 23 23 -1 23 0 0 -2 109 23 23 -2 92 23 -2 93 
23 -1 23 0 0 -2 87 -1 23 0 0 -2 88 -1 23 0 0 -2 88 -1 23 0 0 -2 88 -1 23 0 0 -2 89 23 -2 91 23 -2 92 -1 23 0 0 -2 109 
23 -3 3 23 -1 23 0 0 -2 99 -1 23 0 0 -2 42 -1 23 0 0 -2 44 23 -2 82 23 -2 82 23 -2 92 -1 23 0 0 -2 79 
23 23 -3 3 -2 60 -1 23 0 0 -2 77 23 -2 72 23 -2 91 23 -2 92 23 -2 92 23 -2 92 -1 23 0 0 -2 79 
23 -3 3 23 -1 23 0 0 -2 77 -1 23 0 0 -2 42 -1 23 0 0 -2 44 23 -2 92 -1 23 0 0 -2 42 -1 23 0 0 -2 44 -1 23 0 0 -2 79 
23 -2 47 23 -2 73 -1 23 0 0 -2 87 -1 23 0 0 -2 68 -1 23 0 0 -2 69 23 -2 92 -1 23 0 0 -2 67 -1 23 0 0 -2 68 -1 23 0 0 -2 89 
10 -2 57 1 12 -2 8 -1 23 0 0 -2 67 -1 23 0 0 -2 89 23 -2 92 -1 23 0 0 -2 87 -1 23 0 0 -2 69 23 
10 13 12 -1 23 0 0 -2 77 -1 23 0 0 -2 40 23 -4 3 -2 102 -1 23 0 0 -2 40 -1 23 0 0 -2 79 23 
20 6 24 -1 2 0 0 -2 87 -1 23 0 0 -2 88 -1 23 0 0 -2 88 -1 23 0 0 -2 88 -1 23 0 0 -2 89 23 
-1 138 0 0 -2 19 16 3 14 -1 118 0 0 -2 49 -1 107 0 0 23  23 23 
23 10 13 12 23 -1 127 0 0 23 23 -1 108 0 0 
23 -3 2 10 13 -3 2 12 23 -1 137 0 0 -1 138 0 0 138 -2 128 -1 139 0 0 
23 10 13 12 31 23 23 23 23 
0 26 13 24 25 25 -2 47 25 -2 7 25 25 
10 -1 15 1 1 -2 35 -1 13 1 1 -2 36 3 3 3 -2 57 3 -2 59 -1 32 0 0 -1 33 0 0 
20 -1 21 1 1 -2 45 -1 21 1 1 -2 76 21 6 3 3 -1 32 0 0 -1 33 0 0 
23 -2 72 -1 23 0 0 -2 55 -1 23 0 0 -2 56 23 20 21 21 21 21 
23 23 23 23 23 -3 1 23 -2 61 23 23 23 -2 61 
-1 23 0 0 -2 99 23 23 -2 61 23 23 23 23 23 23 
-1 23 0 0 -2 87 -1 23 0 0 -2 67 -1 23 0 0 -2 68 -1 23 0 0 -2 69 23 -2 64 23 -3 1 23 23 -3 1 -2 52 23 
117 118 119 -1 23 0 0 -2 79 23 23 -2 50 23 23 23 
127 23 -2 41 129 -1 23 0 0 -2 79 23 23 23 23 23 -2 61 
-1 137 0 0 -1 138 0 0 -1 139 0 0 -2 67 -1 23 0 0 -2 89 23 23 -3 1 23 -2 52 23 23 
23 -2 60 23 -1 23 0 0 -2 87 23 23 23 -2 48 23 -2 62 23 -2 50 23 -3 1 
23 -2 72 23 -2 39 23 23 23 -2 50 23 23 23 23 
23 23 -2 17 23 -2 61 23 -1 23 0 0 -2 40 23 -1 23 0 0 -2 40 23 23 
23 -2 51 23 -2 59 23 -1 23 0 0 -2 40 -1 23 1 1 -2 35 -1 23 1 1 -2 36 23 -1 23 0 0 -2 41 23 
23 23 23 23 -1 23 1 1 -2 45 -1 23 1 1 -2 46 23 23 -1 23 0 0 -2 40 
23 23 -1 23 0 0 -2 40 23 -1 23 0 0 -2 55 -1 23 0 0 -2 56 23 23 -1 23 0 0 -2 40 
23 23 -2 51 23 -1 23 0 0 -2 40 23 -2 51 23 23 -1 23 0 0 -2 40 23 
23 23 31 23 23 -1 23 0 0 -2 40 23 23 31 
23 23 23 23 -2 72 23 23 23 -2 61 23 23 
23 -2 51 23 -2 61 23 23 23 23 -2 82 23 23 23 
-1 23 0 0 -2 43 -1 23 0 0 -2 43 -1 23 0 0 -2 43 -1 23 0 0 -2 43 -1 23 0 0 -2 44 23 -2 92 -1 23 0 0 -2 42 -1 23 0 0 -2 43 -1 23 0 0 -2 43 
23 23 -2 51 23 23 23 23 -2 92 23 -3 4 -2 93 23 23 
23 23 23 -2 70 31 23 -2 91 23 -2 92 23 -3 3 23 31 
-1 23 0 0 -2 43 -1 23 0 0 -2 43 -1 23 0 0 -2 43 -1 23 0 0 -2 43 -1 23 0 0 -2 44 23 -2 92 -1 23 0 0 -2 42 -1 23 0 0 -2 43 -1 23 0 0 -2 43 
23 23 23 -2 60 23 -3 4 23 -2 91 23 -2 92 23 -3 4 23 23 -2 51 
-1 23 0 0 -2 43 -1 23 0 0 -2 43 -1 23 0 0 -2 43 -1 23 0 0 -2 43 -1 23 0 0 -2 44 23 -2 92 -1 23 0 0 -2 42 -1 23 0 0 -2 43 -1 23 0 0 -2 43 
23 23 23 -2 70 23 23 23 -2 102 23 23 -2 72 -1 23 1 1 -2 95 
23 23 23 -2 60 23 -2 11 23 23 -2 60 23 23 -1 23 1 1 -2 105 
23 -2 50 23 -2 71 23 23 23 23 -2 62 23 23 -2 73 -1 23 0 0 -2 85 
23 23 -3 5 23 23 -2 50 23 23 23 23 23 
23 -2 74 23 23 -2 61 -1 23 0 0 -2 41 23 -2 73 23 23 23 -2 71 -1 23 0 0 -2 40 
23 -2 70 23 -3 5 23 -2 73 23 23 23 23 23 23 
23 -2 71 23 23 -2 50 23 -3 2 23 -3 2 23 -2 72 23 23 -2 61 23 -2 73 
23 -2 11 23 -2 62 23 23 -2 61 23 -2 50 23 -3 2 23 -2 70 23 23 -2 74 
23 23 23 -1 23 0 0 -2 40 23 23 23 -1 23 0 0 -2 41 23 
23 -2 52 23 -2 70 23 -2 19 23 -2 52 0 2 23 23 23 -2 74 
-1 23 0 0 -2 41 25 -2 7 25 -2 19 25 -2 28 26 -2 39 14 23 23 -1 23 0 0 -2 40 
0 3 -2 59 3 -2 47 31 -3 4 3 -3 4 -2 17 14 23 -2 52 23 -2 74 0 
26 3 3 -2 57 3 -2 58 3 -2 59 24 25 -2 50 25 26 
3 3 3 3 -3 3 3 -3 3 3 3 3 3 
3 3 3 -3 1 3 3 -3 1 3 -3 1 3 3 3 
3 3 3 3 3 3 3 3 3 
-1 32 0 0 -1 33 0 0 -2 64 -1 33 0 0 -1 34 0 0 13 -1 32 0 0 -1 33 0 0 -2 64 -1 33 0 0 -2 54 -1 34 0 0 
-1 32 0 0 -1 33 0 0 -2 54 -1 33 0 0 -2 64 -1 34 0 0 13 13 -1 32 0 0 -1 33 0 0 -2 54 -1 34 0 0 
-1 32 0 0 -2 54 -1 33 0 0 -1 33 0 0 -2 54 -1 33 0 0 -1 34 0 0 13 13 -3 3 13 3 
-1 32 0 0 -1 33 0 0 -2 64 -1 33 0 0 -1 33 0 0 -2 54 -1 33 0 0 -1 33 0 0 -2 64 -1 34 0 0 13 -2 50 -1 32 0 0 
3 13 13 -3 4 13 -2 50 13 13 13 13 3 
-1 34 0 0 -2 64 3 -1 32 0 0 -1 33 0 0 -1 33 0 0 -2 54 -1 33 0 0 -2 54 -1 33 0 0 -1 33 0 0 -1 33 0 0 -2 54 
3 -2 61 3 -1 3 0 0 -2 41 3 3 3 3 13 -1 3 0 0 -2 40 
3 3 -2 50 -1 3 0 0 13 3 3 3 -2 51 13 3 
3 3 3 13 3 3 -3 1 -2 61 3 3 3 
-1 33 0 0 -1 34 0 0 -2 64 3 3 3 3 3 -2 50 13 3 
-1 33 0 0 -2 54 -1 34 0 0 3 3 -2 51 3 3 -1 3 0 0 -2 41 13 3 
-1 33 0 0 -2 54 -1 34 0 0 -2 54 3 3 3 3 -3 1 3 3 3 
-1 33 0 0 -1 34 0 0 -2 64 3 -1 3 0 0 -2 40 3 3 -3 1 3 13 -2 51 3 
-1 33 0 0 -2 64 -1 34 0 0 3 3 3 3 3 3 -2 50 3 
3 3 3 3 -1 32 0 0 -2 53 -1 33 0 0 -2 63 -1 34 0 0 3 -3 3 3 
3 -2 51 3 -3 5 3 13 -1 32 0 0 -1 33 0 0 -2 63 -1 34 0 0 -2 53 3 -3 3 3 
3 3 -1 3 0 0 -2 41 13 -1 32 0 0 -1 33 0 0 -2 63 -1 34 0 0 3 -3 5 -1 3 0 0 -2 40 
3 3 3 3 -1 32 0 0 -2 63 -1 33 0 0 -1 34 0 0 -2 50 3 -3 3 3 
3 3 -2 50 3 3 -1 32 0 0 -2 63 -1 33 0 0 -2 63 -1 34 0 0 -2 53 3 -3 3 3 
3 3 -3 5 3 -2 61 3 -1 32 0 0 -1 33 0 0 -2 63 -1 34 0 0 13 -3 3 3 
3 3 3 3 3 3 3 3 3 
3 3 -1 15 0 0 -2 40 3 3 3 3 3 3 -2 61 
3 3 3 3 3 3 3 -1 15 0 0 -2 41 3 
3 3 3 3 3 -3 1 3 3 3 3 
3 3 3 3 3 3 3 3 3 
3 3 3 3 3 3 3 -2 61 3 3 
3 3 3 3 -1 15 0 0 -2 40 3 3 3 3 
3 3 -3 1 3 3 3 3 -1 32 0 0 -1 33 0 0 -1 34 0 0 
3 3 -3 1 3 3 3 3 -1 32 0 0 -1 33 0 0 -1 34 0 0 
3 3 3 -3 1 3 3 3 -1 32 0 0 -1 33 0 0 -1 34 0 0 
3 3 3 -3 1 3 3 3 -1 32 0 0 -1 33 0 0 -1 34 0 0 
3 3 3 3 3 3 -1 32 0 0 -1 33 0 0 -1 34 0 0 
3 3 3 3 3 3 3 3 3 
3 3 3 -3 2 3 3 3 3 3 3 
3 3 3 3 -3 2 3 3 3 3 3 
3 3 3 3 3 -3 2 3 3 3 3 
3 3 3 3 3 3 3 3 3 
3 3 3 3 3 3 3 3 3 
-1 3 0 0 -2 41 -1 3 0 0 -2 40 -1 3 0 0 -2 40 -1 3 0 0 -2 40 3 -2 82 -1 3 0 0 -2 40 -1 3 0 0 -2 40 -1 3 0 0 -2 40 -1 3 0 0 -2 41 
3 3 3 -1 3 0 0 -2 41 3 -3 5 -2 92 -1 3 0 0 -2 41 3 3 3 
-1 3 0 0 -2 41 -1 3 0 0 -2 40 -1 3 0 0 -2 40 -1 3 0 0 -2 40 3 -2 92 -1 3 0 0 -2 40 -1 3 0 0 -2 40 -1 3 0 0 -2 40 -1 3 0 0 -2 41 
3 3 3 -2 82 -1 3 0 0 3 -2 92 -1 3 0 0 3 -2 82 3 3 
3 3 -2 91 3 -2 92 -1 3 0 0 -2 82 3 -2 92 -1 3 0 0 -2 82 3 -2 92 3 -2 93 3 
3 3 3 -2 102 3 -2 92 3 -2 92 3 -2 92 3 -2 102 3 3 
3 -2 93 3 3 3 3 3 3 3 3 
3 3 3 3 3 3 3 3 3 
3 3 3 3 3 3 3 3 3 