9 200 1

-1 21 0 0 -1 21 0 0 -1 21 0 0 -1 21 0 0 12 -1 21 0 0 -1 21 0 0 -1 21 0 0 -1 21 0 0 
-1 30 0 0 -1 30 0 0 -1 30 0 0 -1 30 0 0 12 -1 30 0 0 -1 30 0 0 -2 32 -1 30 0 0 -2 41 -1 30 0 0 
-1 40 0 0 -1 50 0 0 -1 50 0 0 -1 40 0 0 12 -1 40 0 0 -1 40 0 0 -1 8 0 0 -1 9 0 0 
-1 38 0 0 -1 60 0 0 -1 60 0 0 12 2 2 2 -1 18 0 0 -1 19 0 0 
-1 48 0 0 12 2 2 2 2 2 2 2 
-1 48 0 0 -2 68 12 2 2 2 -1 37 0 0 -1 38 0 0 -2 99 12 2 
-1 59 0 0 12 2 -1 35 0 0 -2 79 -1 36 0 0 -1 46 0 0 -2 89 -1 48 0 0 12 2 
-1 69 0 0 12 2 -1 55 0 0 -1 56 0 0 -1 46 0 0 -1 48 0 0 12 2 
-1 58 0 0 12 2 2 -1 2 0 0 -2 34 -1 57 0 0 -1 58 0 0 12 2 
2 2 2 2 2 2 2 2 2 
-1 2 1 1 -2 20 -1 2 1 1 -2 20 2 -1 2 1 1 -2 20 -1 2 1 1 -2 20 -1 2 1 1 -2 20 2 -1 2 1 1 -2 20 -1 2 1 1 -2 20 
-1 51 0 0 -1 30 1 1 -2 30 12 -1 30 1 1 -2 30 -1 30 1 1 -2 30 -1 30 1 1 -2 30 12 -1 30 1 1 -2 30 -1 30 1 1 -2 30 
-1 61 0 0 -1 40 0 0 12 -1 40 0 0 -1 28 0 0 -1 29 0 0 12 -1 27 0 0 -1 9 0 0 -2 7 
-1 60 0 0 12 2 -3 2 2 -1 18 0 0 -1 19 0 0 12 -3 2 -1 18 0 0 -1 19 0 0 -2 17 
2 2 2 2 2 2 2 2 2 
2 2 2 -1 116 0 0 -2 116 -1 5 0 0 -2 67 12 2 2 -1 37 0 0 
2 2 2 -1 13 0 0 -1 15 0 0 -2 89 -1 12 0 0 -2 33 2 2 -1 47 0 0 -2 89 
2 2 -3 2 2 -1 23 0 0 -1 25 0 0 12 2 -3 2 2 -1 78 0 0 
2 2 2 2 -1 2 0 0 -2 43 2 2 2 -1 88 0 0 -2 68 
-1 2 1 1 -2 20 -1 2 1 1 -2 20 -1 2 1 1 -2 20 2 2 -3 1 2 2 2 -1 47 0 0 
-1 30 1 1 -2 30 -1 30 1 1 -2 30 -1 30 1 1 -2 30 12 2 -1 35 0 0 -1 36 0 0 -2 7 -1 36 0 0 -1 46 0 0 
-1 50 0 0 -1 40 0 0 -1 40 0 0 12 2 -1 55 0 0 -1 56 0 0 -2 17 -1 56 0 0 -1 56 0 0 
-1 61 0 0 12 2 2 2 2 2 2 2 
2 2 -3 2 2 -1 22 1 1 -2 22 12 2 2 2 -3 3 2 
2 -1 2 1 1 -2 20 -1 2 1 1 -2 20 -1 22 0 0 -1 12 1 1 -2 20 -1 2 1 1 -2 20 2 2 2 
2 -1 30 1 1 -2 30 -1 30 1 1 -2 30 -1 22 0 0 -1 30 1 1 -2 30 -1 30 1 1 -2 30 12 -1 22 1 1 -2 22 2 
2 -1 40 0 0 -1 40 0 0 -1 22 0 0 -1 40 0 0 -1 40 0 0 12 -3 2 -1 22 0 0 -1 2 1 1 -2 20 
-1 2 1 1 -2 20 -1 2 1 1 -2 20 2 -1 22 0 0 12 -1 2 1 1 -2 20 -1 2 1 1 -2 20 -1 22 0 0 -1 30 1 1 -2 30 
-1 30 1 1 -2 30 -1 30 1 1 -2 30 2 -3 2 -2 12 -1 22 0 0 12 -3 2 -1 30 1 1 -2 30 -1 30 1 1 -2 30 -1 22 0 0 -1 40 0 0 
-1 40 0 0 -1 40 0 0 2 -2 12 -1 22 0 0 12 -1 40 0 0 -1 40 0 0 -1 22 0 0 12 
2 -1 2 1 1 -2 20 -1 2 1 1 -2 20 -1 22 0 0 12 2 2 -1 22 0 0 12 
2 -1 30 1 1 -2 30 -1 30 1 1 -2 30 -1 22 0 0 -1 65 0 0 2 -3 3 2 -1 21 0 0 12 
2 -1 40 0 0 -1 50 0 0 -1 22 0 0 -1 75 0 0 2 -2 12 2 -1 30 0 0 12 
2 2 -1 60 0 0 -1 22 0 0 -1 75 0 0 -2 20 -1 12 1 1 -2 20 -1 2 1 1 -2 20 -1 40 1 1 -2 20 12 
2 2 2 -4 1 -1 22 0 0 -1 30 0 0 -1 30 1 1 -2 30 -1 30 1 1 -2 30 -1 30 1 1 -2 30 12 
-1 2 1 1 -2 20 -1 2 1 1 -2 20 -1 2 1 1 -2 20 -1 21 0 0 -1 40 0 0 -1 40 0 0 -1 40 0 0 -1 40 0 0 12 
-1 30 1 1 -2 30 -1 30 1 1 -2 30 -1 30 1 1 -2 30 -1 30 0 0 2 -2 12 2 2 2 2 
-1 40 0 0 -1 40 0 0 -1 40 0 0 -1 40 0 0 2 -2 12 -1 2 1 1 -2 20 -1 22 1 1 -2 22 2 -1 2 1 1 -2 20 
2 2 2 2 2 -1 30 1 1 -2 30 -1 22 0 0 12 -1 30 1 1 -2 30 
-1 2 1 1 -2 20 -1 2 1 1 -2 20 -1 2 1 1 -2 20 -1 22 1 1 12 -1 40 0 0 -1 22 0 0 12 -1 40 0 0 
-1 30 1 1 -2 30 -1 30 1 1 -2 30 -1 30 1 1 -2 30 -1 22 0 0 12 2 -1 22 0 0 12 2 
-1 40 0 0 -1 40 0 0 -1 40 0 0 -1 22 0 0 12 2 -1 21 0 0 -1 12 1 1 -2 20 -1 2 1 1 -2 20 
2 2 2 -1 22 0 0 12 2 -1 30 0 0 -1 30 1 1 -2 30 -1 30 1 1 -2 30 
-1 5 0 0 2 2 -1 22 0 0 12 -3 3 2 -1 40 0 0 -1 40 0 0 -1 40 0 0 
-1 15 0 0 -2 77 -1 2 0 0 -2 33 2 -1 22 0 0 12 2 2 2 2 
-1 15 0 0 -2 87 -1 2 0 0 -2 33 2 -1 21 0 0 12 -3 3 2 2 2 2 
-1 25 0 0 2 2 -1 30 0 0 12 2 2 -1 35 0 0 -1 36 0 0 -2 68 
2 2 2 -1 40 0 0 -2 94 12 -3 3 2 2 -1 55 0 0 -1 56 0 0 
2 2 2 -1 2 0 0 -2 84 12 2 2 2 2 
2 2 2 2 2 2 2 2 2 
2 -1 2 1 1 -2 20 -1 2 1 1 -2 20 -1 2 1 1 -2 20 -1 2 1 1 -2 20 -1 2 1 1 -2 20 -1 2 1 1 -2 20 -1 2 1 1 -2 20 -1 2 1 1 -2 20 
2 -1 30 1 1 -2 30 -1 30 1 1 -2 30 -1 30 1 1 -2 30 -1 50 1 1 -1 30 0 1 -2 30 -1 30 0 1 -2 41 -1 30 0 1 -2 30 -1 30 0 1 -2 32 
2 -1 40 0 0 -1 40 0 0 -1 40 0 0 -1 60 0 0 -1 51 0 0 -1 40 0 0 -1 27 0 0 -1 29 0 0 
2 2 2 -1 2 0 0 -2 34 -1 61 0 0 -1 61 0 0 12 -1 18 0 0 -1 19 0 0 
2 2 2 -3 2 2 2 2 2 2 2 
2 2 2 2 2 2 2 2 2 
-1 38 0 0 -2 67 12 2 2 -1 2 0 0 -2 44 2 2 -1 50 1 1 -2 50 -1 50 1 1 -2 50 
-1 59 0 0 12 2 2 -1 37 0 0 -2 68 -1 38 0 0 12 -1 60 0 0 -1 60 0 0 
-1 69 0 0 -2 79 12 2 2 -1 78 0 0 -1 48 0 0 -2 79 12 2 2 
-1 48 0 0 -2 89 12 -4 3 2 2 -1 88 0 0 -1 48 0 0 -2 79 12 -1 50 1 1 -2 50 -1 50 1 1 -2 50 
-1 46 0 0 -2 99 -1 36 0 0 -2 89 -1 36 0 0 -1 36 0 0 -1 46 0 0 -2 89 -1 48 0 0 12 -1 60 0 0 -1 60 0 0 
-1 56 0 0 -1 56 0 0 -1 56 0 0 -1 56 0 0 -1 56 0 0 -1 85 0 0 12 2 2 
2 2 2 2 2 2 2 -1 50 1 1 -2 50 -1 50 1 1 -2 50 
2 2 2 2 -3 3 2 2 2 -1 60 0 0 -1 60 0 0 
2 2 -1 37 0 0 -1 36 0 0 -1 38 0 0 12 2 -3 3 2 2 
2 2 -1 55 0 0 -1 46 0 0 -2 52 -1 48 0 0 12 2 2 2 
2 2 -1 2 0 0 -2 34 -1 47 0 0 -2 86 -1 48 0 0 12 2 -1 116 0 0 -1 4 0 0 
2 2 2 -1 47 0 0 -1 48 0 0 12 2 -1 13 0 0 -1 14 0 0 -2 6 
2 2 2 -1 47 0 0 -1 48 0 0 12 2 -1 13 0 0 -1 14 0 0 -2 6 
2 2 2 -1 47 0 0 -1 48 0 0 12 2 -1 13 0 0 -1 14 0 0 
2 2 2 -1 57 0 0 -1 58 0 0 12 2 -1 23 0 0 -1 24 0 0 
2 2 2 2 2 2 2 -1 2 0 0 -2 43 -1 2 0 0 -2 43 
2 2 2 2 2 2 2 2 2 
-1 22 0 0 -1 2 1 1 -2 20 -1 2 1 1 -2 20 -1 2 1 1 -2 20 2 2 -1 2 1 1 -2 20 -1 2 1 1 -2 20 -1 2 1 1 -2 20 
-1 22 0 0 -1 30 1 1 -2 30 -1 30 1 1 -2 30 -1 30 1 1 -2 30 12 2 -1 30 1 1 -2 30 -1 30 1 1 -2 30 -1 30 1 1 -2 30 
-1 22 0 0 -1 51 0 0 -1 40 0 0 -1 40 0 0 12 2 -3 4 -1 40 0 0 -1 40 0 0 -1 40 0 0 -2 114 
-1 22 0 0 -1 61 0 0 12 2 2 2 2 2 -1 2 0 0 -2 84 
-1 21 0 0 12 2 2 2 -3 2 2 2 2 2 
-1 30 0 0 -2 41 12 2 2 2 2 2 -3 1 2 2 
-1 40 0 0 12 2 2 2 2 2 2 2 
2 2 2 2 2 2 2 2 2 
2 2 -3 2 2 -3 2 2 -3 2 2 2 -3 3 2 2 2 
2 2 -3 2 2 -4 2 2 -3 3 2 2 2 2 2 
2 2 2 2 2 2 2 2 2 
2 2 2 -3 2 2 2 2 -3 3 2 2 2 
2 2 2 2 2 2 2 2 2 
-1 2 1 1 -2 20 -1 2 1 1 -2 20 -1 2 1 1 -2 20 -1 22 1 1 -1 2 1 1 -2 20 -1 2 1 1 -2 20 -1 2 1 1 -2 20 2 -1 2 1 1 -2 20 
-1 30 0 1 -1 30 0 1 -2 32 -1 30 0 1 -1 22 0 0 -1 30 0 1 -2 42 -1 30 0 1 -1 30 0 1 12 -1 30 0 1 
-1 8 0 0 -2 7 -1 9 0 0 -1 50 0 0 -1 22 0 0 -1 40 0 0 -1 40 0 0 -1 40 0 0 12 -1 40 0 0 
-1 18 0 0 -2 17 -1 19 0 0 -1 61 0 0 -1 21 0 0 12 2 2 2 2 
2 2 2 -1 30 0 0 -2 42 12 2 2 2 2 
2 2 2 -1 40 0 0 12 2 2 2 2 
2 2 2 2 2 -3 2 2 -3 2 2 2 -3 2 2 
2 2 2 2 -3 2 2 2 2 2 2 
2 2 -1 35 0 0 -1 36 0 0 -2 53 -1 36 0 0 -2 53 -1 36 0 0 -2 62 -1 36 0 0 -2 79 -1 65 0 0 -2 89 2 
2 2 -3 2 -1 45 0 0 -1 46 0 0 -1 46 0 0 -2 63 -1 46 0 0 -2 54 -1 46 0 0 -2 54 -1 75 0 0 -2 54 12 
2 2 -1 55 0 0 -1 56 0 0 -1 56 0 0 -1 56 0 0 -1 56 0 0 -1 85 0 0 12 
2 2 2 -3 2 2 2 2 2 2 2 
-1 4 0 0 -2 62 -1 4 0 0 -2 52 -1 5 0 0 -2 53 2 2 -3 2 2 2 2 3 
-1 14 0 0 -1 14 0 0 -2 62 -1 15 0 0 -2 53 -1 2 0 0 -2 33 2 2 -1 50 1 1 -2 50 -1 50 1 1 -2 50 -1 50 1 1 -2 50 
-1 14 0 0 -1 14 0 0 -1 15 0 0 -2 64 -1 2 0 0 -2 33 2 2 -1 60 0 0 -1 60 0 0 -1 60 0 0 
-1 24 0 0 -1 24 0 0 -1 25 0 0 2 2 2 2 2 2 
-1 2 1 1 -2 103 -1 2 1 1 -2 103 -1 2 1 1 -2 103 -1 2 1 1 -2 103 -1 2 1 1 -2 101 -1 2 1 1 -2 102 -1 2 1 1 -2 103 -1 2 1 1 -2 103 -1 2 1 1 -2 103 
-1 105 0 0 -1 105 0 0 -1 105 0 0 -1 105 0 0 111 112 -1 105 0 0 -1 105 0 0 -1 105 0 0 
-1 115 0 0 -2 114 -1 115 0 0 -1 115 0 0 -1 51 0 0 111 112 -1 51 0 0 -1 115 0 0 -1 115 0 0 -2 114 
-1 73 0 0 -2 84 73 -4 3 73 -1 61 0 0 121 122 -1 61 0 0 73 -1 73 0 0 -2 84 
73 73 73 73 -3 3 73 73 73 -1 73 1 1 -2 16 73 
73 -1 70 0 0 -1 72 0 0 -2 87 73 73 73 -1 70 0 0 -2 86 -1 72 0 0 -2 26 73 
-1 73 0 0 -2 34 -1 80 0 0 -2 86 -1 82 0 0 -2 53 73 73 -1 73 0 0 -2 34 -1 80 0 0 -2 64 -1 82 0 0 -2 87 -1 73 0 0 -2 33 
-1 73 0 0 -2 34 -1 80 0 0 -2 62 -1 82 0 0 -1 73 0 0 -2 33 73 -3 3 73 -1 80 0 0 -2 86 -1 82 0 0 -2 77 73 
73 -1 90 0 0 -1 92 0 0 73 73 73 -1 90 0 0 -1 92 0 0 73 
73 73 73 73 73 73 73 73 73 
73 73 -1 70 0 0 -1 71 0 0 -2 67 -1 71 0 0 -2 54 -1 71 0 0 -1 72 0 0 73 73 
73 73 -3 1 -1 80 0 0 -1 81 0 0 -2 52 -1 81 0 0 -2 63 -1 81 0 0 -2 63 -1 82 0 0 73 73 -3 1 
73 73 -1 90 0 0 -1 91 0 0 -1 91 0 0 -1 91 0 0 -1 92 0 0 73 73 
73 73 73 -1 73 0 0 -2 43 -1 73 0 0 -2 43 -1 73 0 0 -2 43 73 73 73 
73 73 73 73 -3 1 73 73 73 73 73 -3 1 
73 73 73 73 73 -3 1 73 73 73 73 
73 73 73 73 73 73 73 73 73 
73 -1 73 1 1 -2 95 -1 73 1 1 -2 95 -1 73 1 1 -2 95 -1 73 1 1 -2 95 -1 73 1 1 -2 95 -1 73 1 1 -2 95 -1 73 1 1 -2 95 73 
73 -1 105 0 1 -2 105 -1 105 0 1 -2 105 -1 105 0 1 -2 105 -1 105 0 1 -2 105 -1 105 0 1 -2 105 -1 105 0 1 -2 105 -1 105 0 1 -2 105 83 
73 -1 115 0 0 -1 115 0 0 -1 115 0 0 -1 50 0 0 -1 50 0 0 -1 115 0 0 -1 115 0 0 83 
73 73 73 73 -1 60 0 0 -1 60 0 0 83 73 73 
73 73 -3 3 73 73 73 73 73 73 73 
73 73 73 73 73 -1 73 0 0 -2 44 73 73 73 
73 -1 73 0 0 -2 34 -1 70 0 0 -2 86 -1 71 0 0 -2 54 -1 71 0 0 -2 63 -1 72 0 0 -2 87 -1 73 0 0 -2 33 73 73 
73 -1 73 0 0 -2 34 -1 80 0 0 -2 86 -1 81 0 0 -2 62 -1 81 0 0 -2 6 -1 82 0 0 -2 87 -1 73 0 0 -2 33 73 73 -3 3 
73 -1 73 0 0 -2 34 -1 80 0 0 -2 86 -1 81 0 0 -2 52 -1 81 0 0 -2 53 -1 82 0 0 -2 87 -1 73 0 0 -2 33 73 73 
73 73 -1 90 0 0 -1 91 0 0 -1 91 0 0 -1 92 0 0 73 73 73 
73 73 73 73 -1 73 0 0 -2 43 73 73 -3 3 73 73 
73 73 -3 3 73 73 73 73 73 73 73 
73 73 73 73 73 73 73 73 73 
-1 73 1 1 -2 100 -1 73 1 1 -2 101 -1 73 1 1 -2 102 -1 73 1 1 -2 103 -1 73 1 1 -2 103 -1 73 1 1 -2 100 -1 73 1 1 -2 101 -1 73 1 1 -2 102 -1 73 1 1 -2 103 
-1 105 0 0 111 112 -1 105 0 0 -1 105 0 0 -2 31 -1 105 0 0 111 112 -1 105 0 0 
-1 115 0 0 111 112 -1 115 0 0 -2 74 -1 115 0 0 -1 115 0 0 -2 94 111 112 -1 115 0 0 
-1 73 0 0 -2 106 121 122 -1 83 0 0 -2 84 73 -1 73 0 0 -2 84 121 122 -1 83 0 0 -2 106 
73 73 73 73 73 73 73 73 73  
73 73 73 -3 1 73 -3 1 73 73 -3 1 73 73 -1 73 0 0 -2 44 
73 73 73 73 73 73 -1 70 0 0 -1 71 0 0 -2 106 -1 72 0 0 
-1 73 0 0 -2 97 83 73 -3 1 73 73 -1 73 0 0 -2 34 -1 80 0 0 -2 104 -1 81 0 0 -2 6 -1 82 0 0 
-1 73 0 0 -2 107 83 73 73 73 -1 73 0 0 -2 34 -1 80 0 0 -2 76 -1 81 0 0 -2 52 -1 82 0 0 
73 73 73 73 -3 1 73 -3 1 73 -1 90 0 0 -1 91 0 0 -1 92 0 0 
-1 73 0 0 -2 97 83 73 73 73 73 73 -1 73 0 0 -2 43 73 
-1 73 0 0 -2 107 83 73 73 73 73 73 -3 1 73 73 
-1 73 1 1 -2 100 -1 73 1 1 -2 100 -1 73 1 1 -2 100 -1 73 1 1 -2 100 -1 73 1 1 -2 101 -1 73 1 1 -2 102 -1 73 1 1 -2 103 -1 73 1 1 -2 103 -1 73 1 1 -2 103 
-1 115 0 0 -1 115 0 0 -1 115 0 0 -1 51 0 0 111 112 -1 115 0 0 -1 115 0 0 -1 115 0 0 -2 114 
73 73 73 -1 60 0 0 121 122 -1 83 0 0 -2 106 73 -1 73 0 0 -2 84 
73 -3 2 73 73 73 73 73 73 73 73 
73 73 73 73 73 -3 2 73 73 73 73 -3 2 
73 73 -1 70 0 0 -2 79 -1 72 0 0 -2 67 73 73 -1 70 0 0 -2 89 -1 72 0 0 -2 68 73 
73 73 -1 90 0 0 -1 92 0 0 73 73 -1 90 0 0 -1 92 0 0 73 
73 -3 2 73 73 73 -1 73 1 1 -2 16 -1 73 1 1 -2 16 73 73 73 -3 2 
73 -3 2 73 73 -1 70 0 0 -1 71 0 0 -2 26 -1 71 0 0 -2 26 -1 72 0 0 73 73 
73 73 -1 73 0 0 -2 34 -1 80 0 0 -2 67 -1 81 0 0 -2 106 -1 81 0 0 -2 106 -1 82 0 0 -2 52 -1 73 0 0 -2 33 73 
73 73 -1 73 0 0 -2 34 -1 80 0 0 -1 81 0 0 -2 113 -1 81 0 0 -2 113 -1 82 0 0 -1 73 0 0 -2 33 73 
-1 73 0 0 -2 98 73 73 -1 90 0 0 -1 91 0 0 -1 91 0 0 -1 92 0 0 73 73 
-1 73 0 0 -2 107 73 73 -3 2 73 -1 73 0 0 -2 43 -1 73 0 0 -2 43 73 73 73 
73 73 73 73 73 73 73 73 73 -3 2 
-1 73 1 1 -2 95 -1 73 1 1 -2 95 -1 73 1 1 -2 95 -1 73 1 1 -2 95 73 73 -1 73 1 1 -2 95 -1 73 1 1 -2 95 -1 73 1 1 -2 95 
-1 73 1 1 -2 105 -1 105 1 1 -2 105 -1 105 1 1 -2 105 -1 73 1 1 -2 105 73 73 -1 73 1 1 -2 105 -1 105 1 1 -2 105 -1 73 1 1 -2 105 
-1 115 0 0 -1 115 0 0 -2 94 -1 115 0 0 -1 115 0 0 73 73 -1 115 0 0 -1 115 0 0 -1 115 0 0 -2 94 
73 -1 73 0 0 -2 84 73 73 73 73 73 73 -1 73 0 0 -2 84 
73 73 73 73 73 73 73 73 73 
-1 73 1 1 -2 103 -1 73 1 1 -2 101 -1 73 1 1 -2 102 -1 73 1 1 -2 103 -1 73 1 1 -2 103 -1 73 1 1 -2 103 -1 73 1 1 -2 101 -1 73 1 1 -2 102 -1 73 1 1 -2 103 
-1 105 0 0 111 112 -1 105 0 0 -1 105 0 0 -2 42 -1 105 0 0 111 112 -1 105 0 0 
-1 115 0 0 111 112 -1 115 0 0 -2 94 -1 115 0 0 -1 115 0 0 -2 94 111 112 -1 115 0 0 
-1 73 0 0 -2 106 121 122 -1 83 0 0 -2 84 73 -1 73 0 0 -2 84 121 122 -1 83 0 0 -2 106 
73 73 73 73 73 73 73 73 73 
73 73 73 73 -1 73 1 1 -3 5 -2 16 73 73 73 73 
73 -1 70 0 0 -1 71 0 0 -2 67 -1 71 0 0 -1 71 0 0 -2 26 -1 71 0 0 -1 71 0 0 -2 6 -1 72 0 0 73 
73 -1 90 0 0 -1 91 0 0 -1 91 0 0 -1 91 0 0 -1 91 0 0 -1 91 0 0 -1 92 0 0 73 
73 73 73 73 -1 73 1 1 -3 5 -2 16 73 -1 73 1 1 -2 16 73 73 
73 -1 70 0 0 -1 71 0 0 -2 6 -1 71 0 0 -1 71 0 0 -2 26 -1 71 0 0 -1 71 0 0 -2 26 -1 72 0 0 73 
73 -1 90 0 0 -1 91 0 0 -1 91 0 0 -1 91 0 0 -1 91 0 0 -1 91 0 0 -1 92 0 0 73 
73 73 73 73 73 -3 5 -1 73 1 1 -2 16 -1 73 1 1 -2 16 73 73 
73 -1 70 0 0 -1 71 0 0 -1 71 0 0 -1 71 0 0 -2 6 -1 71 0 0 -2 26 -1 71 0 0 -2 26 -1 72 0 0 73 
73 -1 90 0 0 -1 91 0 0 -1 91 0 0 -1 91 0 0 -1 91 0 0 -1 91 0 0 -1 92 0 0 73 
73 73 73 73 73 73 73 73 73 
73 73 73 73 73 73 73 73 73 
-1 70 0 0 -1 72 0 0 -2 106 73 73 73 73 73 -1 70 0 0 -2 106 -1 73 0 0 -2 72 
-1 73 0 0 -2 90 -1 92 0 0 73 73 73 -3 5 73 73 -1 73 0 0 -2 90 -1 73 0 0 -2 92 
73 73 73 73 73 73 73 73 73 
73 73 73 73 73 73 73 73 73 
-1 73 1 1 -2 100 -1 73 1 1 -2 100 -1 73 1 1 -2 100 -1 73 1 1 -2 101 -1 73 1 1 -2 102 -1 73 1 1 -2 103 -1 73 1 1 -2 103 -1 73 1 1 -2 103 -1 73 1 1 -2 103 
-1 105 0 0 -1 105 0 0 -2 31 -1 105 0 0 111 112 -1 105 0 0 -1 105 0 0 -2 41 -1 105 0 0 -2 42 -1 105 0 0 
-1 115 0 0 -1 115 0 0 -1 115 0 0 -2 94 111 112 -1 115 0 0 -2 94 -1 115 0 0 -1 115 0 0 -1 115 0 0 
73 73 -1 73 0 0 -2 84 121 122 -1 73 0 0 -2 84 73 73 73 73 73 
73 73 73 73 73 73 73 73 73 
73 73 73 73 73 73 73 73 73 
73 73 73 73 73 73 73 73 73 
73 73 73 73 73 73 73 73 73 
70 71 -2 6 71 72 73 70 71 71 -2 6 72 
90 91 91 92 73 -3 6 90 91 91 92 
83 83 83 83 73 83 83 83 83 
73 73 73 73 73 73 73 73 73 
73 73 73 73 73 73 73 73 73 
73 73 73 73 73 73 73 73 73 
3 3 3 3 3 3 3 3 3 
3 3 3 3 3 3 3 3 3 
3 3 3 3 3 3 3 3 3 